----------------- Maze: 0 ---------------------------- 
##E##
#...#
#...#
#S..#
#####

----------------- Maze: 1 ---------------------------- 
#####E#
#.#.#.#
#.....#
##.####
#....S#
#.#..##
#######

----------------- Maze: 2 ---------------------------- 
##########
#S.......#
########.#
#........#
#.########
#........#
########.#
#........#
#.########
#E########

----------------- Maze: 3 ---------------------------- 
#####E####
#...#....#
#.######.#
#.#......#
#.###.####
#....S...#
#####.##.#
#..##.####
##.......#
##########

----------------- Maze: 4 ---------------------------- 
###E###########
#........###..#
########.....##
#.....##.###.##
#.###.....##..#
#.....###...###
####.####.#.###
##......#.....#
#######.#.###.#
#.........#####
#.####.S#....##
##....#.#######
#..##.........#
##...###.##.###
###############

----------------- Maze: 5 ---------------------------- 
##################
##...#####...#####
##.#.##....#.....#
##.S....##...###.#
###.####.#.#.....#
#........#.##.####
##.#######......##
##......##########
#####.####....##.#
##.........##..#.#
#######.#####.##.#
####.##.##.....#.#
####.##.########.#
#................#
#..###############
##.#.##.#.##.##.##
##...............#
##########E#######

----------------- Maze: 6 ---------------------------- 
####################
#..................#
#.##############.###
#.########.......###
#.#........######..#
#.##.##.##........##
#.#...#.##.######.##
#.###.#.##.....##.##
#.###..##########.##
#.####.###.........#
#.#....#...####.####
#.#.####.####.....##
#.#......#......####
#.###.####.#####...#
#.#......#.....#.###
#.######...#####.#.#
#.#.....##S#...#.#.#
#.#########..#.....#
#..........###.##.##
##########E#########

